####################/
#P.......WWW......../
#...........R......./
#p................../
#......TTTTTT.###..#/
####################+
####################/
..................../
........QQQ........./
....B.........R...../
#......####........./
####################+
####################/
.......WWW.B.......#/
................R..#/
..............T....#/
.......QQQ.........O/      
####################+
